========== =========
=                 *=
= ========     !   =
                    
=    ===============
                g   
========== =========
=                  =
= ======    ====== =
=      = ** =g   = =
= =   G= ** =      =
= ======    ====== =
=                  =
========== =========
                    
===============    =
                    
=   G *   ======== =
=                 *=
========== =========
