==========.=========
= ................*=
=.        .........=
=..................=
=....===============
=...............g..=
==========.=========
=..................=
=.======....======.=
=......=.**.=g...=.=
=.=...G=.**.=......=
=.======....======.=
=..................=
====        ========
=..................=
===       =====....=
=..................=
=...G.*...    P   .=
=.................*=
==========.=========
