==========.=========
=P................*=
=..=======.........=
....................
=....===============
................g...
==========.=========
=..................=
=.======....======.=
=......=.**.=g...=.=
=.=...G=.**.=......=
=.======....======.=
=..................=
==========.=========
....................
===============....=
....................
=...G.*...========.=
=.................*=
==========.=========
